00000000000
00000000000
00000100000
00001110000
00010101000
00010101000
00001110000
00000100000
00000000000
00000000000
00000100000
00001110000
00010101000
00010101000
00001110000
00000100000
00000000000
00000000000
